{
  "name": "pm0100",
  "version": "2.0.0",
  "total_characters": 247,
  "layers": {
    "base": {
      "q": "க்",
      "w": "ங்",
      "e": "ச்",
      "r": "ஞ்",
      "t": "ட்",
      "y": "ண்",
      "u": "த்",
      "i": "ந்",
      "o": "ப்",
      "p": "ம்",
      "a": "ய்",
      "s": "ர்",
      "d": "ல்",
      "f": "வ்",
      "g": "ழ்",
      "h": "ள்",
      "j": "ற்",
      "k": "ன்",
      "l": "ஃ"
    },
    "vowels": {
      "z": "அ",
      "x": "இ",
      "c": "உ",
      "v": "எ",
      "b": "ஒ"
    },
    "vowels_long": {
      "z": "ஆ",
      "x": "ஈ",
      "c": "ஊ",
      "v": "ஏ",
      "b": "ஓ"
    },
    "vowels_special": {
      "n": "ஐ",
      "m": "ஔ"
    }
  },
  "modifiers": {
    "nedil_shift": "swipe_up",
    "combinations": {
      "க்+அ": "க",
      "க்+ஆ": "கா",
      "க்+இ": "கி",
      "க்+ஈ": "கீ",
      "க்+உ": "கு",
      "க்+ஊ": "கூ",
      "க்+எ": "கெ",
      "க்+ஏ": "கே",
      "க்+ஐ": "கை",
      "க்+ஒ": "கொ",
      "க்+ஓ": "கோ",
      "க்+ஔ": "கௌ",
      "ங்+அ": "ங",
      "ங்+ஆ": "ஙா",
      "ங்+இ": "ஙி",
      "ங்+ஈ": "ஙீ",
      "ங்+உ": "ஙு",
      "ங்+ஊ": "ஙூ",
      "ங்+எ": "ஙெ",
      "ங்+ஏ": "ஙே",
      "ங்+ஐ": "ஙை",
      "ங்+ஒ": "ஙொ",
      "ங்+ஓ": "ஙோ",
      "ங்+ஔ": "ஙௌ",
      "ச்+அ": "ச",
      "ச்+ஆ": "சா",
      "ச்+இ": "சி",
      "ச்+ஈ": "சீ",
      "ச்+உ": "சு",
      "ச்+ஊ": "சூ",
      "ச்+எ": "செ",
      "ச்+ஏ": "சே",
      "ச்+ஐ": "சை",
      "ச்+ஒ": "சொ",
      "ச்+ஓ": "சோ",
      "ச்+ஔ": "சௌ",
      "ஞ்+அ": "ஞ",
      "ஞ்+ஆ": "ஞா",
      "ஞ்+இ": "ஞி",
      "ஞ்+ஈ": "ஞீ",
      "ஞ்+உ": "ஞு",
      "ஞ்+ஊ": "ஞூ",
      "ஞ்+எ": "ஞெ",
      "ஞ்+ஏ": "ஞே",
      "ஞ்+ஐ": "ஞை",
      "ஞ்+ஒ": "ஞொ",
      "ஞ்+ஓ": "ஞோ",
      "ஞ்+ஔ": "ஞௌ",
      "ட்+அ": "ட",
      "ட்+ஆ": "டா",
      "ட்+இ": "டி",
      "ட்+ஈ": "டீ",
      "ட்+உ": "டு",
      "ட்+ஊ": "டூ",
      "ட்+எ": "டெ",
      "ட்+ஏ": "டே",
      "ட்+ஐ": "டை",
      "ட்+ஒ": "டொ",
      "ட்+ஓ": "டோ",
      "ட்+ஔ": "டௌ",
      "ண்+அ": "ண",
      "ண்+ஆ": "ணா",
      "ண்+இ": "ணி",
      "ண்+ஈ": "ணீ",
      "ண்+உ": "ணு",
      "ண்+ஊ": "ணூ",
      "ண்+எ": "ணெ",
      "ண்+ஏ": "ணே",
      "ண்+ஐ": "ணை",
      "ண்+ஒ": "ணொ",
      "ண்+ஓ": "ணோ",
      "ண்+ஔ": "ணௌ",
      "த்+அ": "த",
      "த்+ஆ": "தா",
      "த்+இ": "தி",
      "த்+ஈ": "தீ",
      "த்+உ": "து",
      "த்+ஊ": "தூ",
      "த்+எ": "தெ",
      "த்+ஏ": "தே",
      "த்+ஐ": "தை",
      "த்+ஒ": "தொ",
      "த்+ஓ": "தோ",
      "த்+ஔ": "தௌ",
      "ந்+அ": "ந",
      "ந்+ஆ": "நா",
      "ந்+இ": "நி",
      "ந்+ஈ": "நீ",
      "ந்+உ": "நு",
      "ந்+ஊ": "நூ",
      "ந்+எ": "நெ",
      "ந்+ஏ": "நே",
      "ந்+ஐ": "நை",
      "ந்+ஒ": "நொ",
      "ந்+ஓ": "நோ",
      "ந்+ஔ": "நௌ",
      "ப்+அ": "ப",
      "ப்+ஆ": "பா",
      "ப்+இ": "பி",
      "ப்+ஈ": "பீ",
      "ப்+உ": "பு",
      "ப்+ஊ": "பூ",
      "ப்+எ": "பெ",
      "ப்+ஏ": "பே",
      "ப்+ஐ": "பை",
      "ப்+ஒ": "பொ",
      "ப்+ஓ": "போ",
      "ப்+ஔ": "பௌ",
      "ம்+அ": "ம",
      "ம்+ஆ": "மா",
      "ம்+இ": "மி",
      "ம்+ஈ": "மீ",
      "ம்+உ": "மு",
      "ம்+ஊ": "மூ",
      "ம்+எ": "மெ",
      "ம்+ஏ": "மே",
      "ம்+ஐ": "மை",
      "ம்+ஒ": "மொ",
      "ம்+ஓ": "மோ",
      "ம்+ஔ": "மௌ",
      "ய்+அ": "ய",
      "ய்+ஆ": "யா",
      "ய்+இ": "யி",
      "ய்+ஈ": "யீ",
      "ய்+உ": "யு",
      "ய்+ஊ": "யூ",
      "ய்+எ": "யெ",
      "ய்+ஏ": "யே",
      "ய்+ஐ": "யை",
      "ய்+ஒ": "யொ",
      "ய்+ஓ": "யோ",
      "ய்+ஔ": "யௌ",
      "ர்+அ": "ர",
      "ர்+ஆ": "ரா",
      "ர்+இ": "ரி",
      "ர்+ஈ": "ரீ",
      "ர்+உ": "ரு",
      "ர்+ஊ": "ரூ",
      "ர்+எ": "ரெ",
      "ர்+ஏ": "ரே",
      "ர்+ஐ": "ரை",
      "ர்+ஒ": "ரொ",
      "ர்+ஓ": "ரோ",
      "ர்+ஔ": "ரௌ",
      "ல்+அ": "ல",
      "ல்+ஆ": "லா",
      "ல்+இ": "லி",
      "ல்+ஈ": "லீ",
      "ல்+உ": "லு",
      "ல்+ஊ": "லூ",
      "ல்+எ": "லெ",
      "ல்+ஏ": "லே",
      "ல்+ஐ": "லை",
      "ல்+ஒ": "லொ",
      "ல்+ஓ": "லோ",
      "ல்+ஔ": "லௌ",
      "வ்+அ": "வ",
      "வ்+ஆ": "வா",
      "வ்+இ": "வி",
      "வ்+ஈ": "வீ",
      "வ்+உ": "வு",
      "வ்+ஊ": "வூ",
      "வ்+எ": "வெ",
      "வ்+ஏ": "வே",
      "வ்+ஐ": "வை",
      "வ்+ஒ": "வொ",
      "வ்+ஓ": "வோ",
      "வ்+ஔ": "வௌ",
      "ழ்+அ": "ழ",
      "ழ்+ஆ": "ழா",
      "ழ்+இ": "ழி",
      "ழ்+ஈ": "ழீ",
      "ழ்+உ": "ழு",
      "ழ்+ஊ": "ழூ",
      "ழ்+எ": "ழெ",
      "ழ்+ஏ": "ழே",
      "ழ்+ஐ": "ழை",
      "ழ்+ஒ": "ழொ",
      "ழ்+ஓ": "ழோ",
      "ழ்+ஔ": "ழௌ",
      "ள்+அ": "ள",
      "ள்+ஆ": "ளா",
      "ள்+இ": "ளி",
      "ள்+ஈ": "ளீ",
      "ள்+உ": "ளு",
      "ள்+ஊ": "ளூ",
      "ள்+எ": "ளெ",
      "ள்+ஏ": "ளே",
      "ள்+ஐ": "ளை",
      "ள்+ஒ": "ளொ",
      "ள்+ஓ": "ளோ",
      "ள்+ஔ": "ளௌ",
      "ற்+அ": "ற",
      "ற்+ஆ": "றா",
      "ற்+இ": "றி",
      "ற்+ஈ": "றீ",
      "ற்+உ": "று",
      "ற்+ஊ": "றூ",
      "ற்+எ": "றெ",
      "ற்+ஏ": "றே",
      "ற்+ஐ": "றை",
      "ற்+ஒ": "றொ",
      "ற்+ஓ": "றோ",
      "ற்+ஔ": "றௌ",
      "ன்+அ": "ன",
      "ன்+ஆ": "னா",
      "ன்+இ": "னி",
      "ன்+ஈ": "னீ",
      "ன்+உ": "னு",
      "ன்+ஊ": "னூ",
      "ன்+எ": "னெ",
      "ன்+ஏ": "னே",
      "ன்+ஐ": "னை",
      "ன்+ஒ": "னொ",
      "ன்+ஓ": "னோ",
      "ன்+ஔ": "னௌ"
    }
  }
}
